1111111111111
10010000000C1
1000011111001
1P0011E0C0001
1111100001111
1000000000001
1001111100001
1111111111001
1000000000001
1000000C00001
1111111111111
