1111111111111
10010000000C1
1000011111001
100011E0C0001
1111100001111
10000P0000001
1001111000001
1111111111001
1000000000001
1000110C00001
1111111111111
