1111111111111111111111111
11110000000000000000000C1
1000011111000000001111111
100011E0C0000001111100001
1111100001110000000000001
1000000001011000000000011
10C1111000000000001110001
1111111111000101000000001
1000000000000101001100001
10P0110C00C0010C000111101
1111111111111111111111111