111111111111111111111111111
111110000000000000000000C11
110000111110000000011111111
1100011E0C00000011111000011
111111000011100000000000011
110000000010110000000000111
110C11110000000000011100011
111111111110001010000000011
110000000000001010011000011
110P0110C00C0010C0001111011
111111111111111111111111111
111111111111111111111111111